{
  "levels": {
    "one": [
      [0, 0, 0, 0, 0],
      [0, 0, 0, 0, 0],
      [0, 0, 0, 0, 0],
      [1, 0, 0, 0, 0],
      [0, 0, 0, 0, 0]
    ],
    "two": [
      [0, 0, 0, 0, 0],
      [0, 0, 0, 0, 0],
      [0, 0, 1, 0, 0],
      [0, 0, 0, 0, 0],
      [0, 0, 0, 0, 0]
    ],
    "three": [
      [0, 0, 2, 1, 0],
      [0, 0, 0, 0, 0],
      [0, 0, 0, 0, 0],
      [0, 0, 0, 0, 0],
      [0, 0, 0, 0, 0]
    ],
    "four": [
      [0, 0, 0, 0, 0],
      [0, 0, 0, 0, 0],
      [0, 0, 0, 0, 0],
      [0, 0, 0, 0, 0],
      [0, 0, 0, 0, 1]
    ],
    "five": [
      [0, 0, 0, 0, 0],
      [0, 0, 0, 0, 0],
      [0, 0, 0, 0, 0],
      [0, 0, 0, 0, 0],
      [0, 0, 0, 1, 0]
    ],
    "six": [
      [0, 0, 0, 0, 0],
      [0, 0, 0, 0, 0],
      [0, 0, 0, 0, 0],
      [0, 0, 0, 0, 0],
      [0, 0, 1, 0, 0]
    ],
    "seven": [
      [0, 0, 0, 0, 0],
      [0, 0, 0, 0, 0],
      [0, 0, 0, 0, 0],
      [0, 0, 0, 0, 0],
      [0, 1, 0, 0, 0]
    ],
    "eight": [
      [0, 0, 0, 0, 0],
      [0, 0, 0, 0, 0],
      [0, 0, 0, 0, 0],
      [0, 0, 0, 0, 0],
      [1, 0, 0, 0, 0]
    ],
    "nine": [
      [0, 0, 0, 0, 0],
      [0, 0, 0, 0, 0],
      [0, 0, 0, 0, 0],
      [0, 0, 0, 0, 1],
      [0, 0, 0, 0, 0]
    ],
    "ten": [
      [0, 0, 0, 0, 0],
      [0, 0, 0, 0, 0],
      [0, 0, 0, 0, 0],
      [0, 0, 0, 1, 0],
      [0, 0, 0, 0, 0]
    ]
  }
}